- 1 0 0 0 0 2 - - - - - - - - - - - - - 1 0 0 0 2 -
- 3 4 % % 4 5 - - - - - - - - - - - - - 6 7 7 7 8 -
- 6 7 7 7 7 8 - - - - - - - - - - - - - - - - - - -
- 
-
-
- - 1 0 0 0 0 2 -
- - 3 % 4 % % % 9 9 0 0 0 0 0 0 0 0 0 0 0 0 0 0 2 -
- - 3 4 4 4 4 4 4 4 4 4 4 4 4 4 4 4 4 4 4 4 4 4 5 -
- - 6 7 7 7 7 7 7 7 7 7 7 7 7 7 7 7 7 7 7 7 7 7 8 -